Bulbasaur => Bulbasaur
Ivysaur => Servine
Venusaur => Torterra
Charmander => Fennekin
Charmeleon => Quilava
Charizard => Blaziken
Squirtle => Mudkip
Wartortle => Dewott
Blastoise => Greninja
Caterpie => Caterpie
Metapod => Charjabug
Butterfree => Xatu
Weedle => Dunsparce
Kakuna => Leavanny
Beedrill => Vespiquen
Pidgey => Fletchling
Pidgeotto => Staraptor
Pidgeot => Talonflame
Rattata => Tandemaus
Raticate => Lopunny
Spearow => Murkrow
Fearow => Honchkrow
Ekans => Joltik
Arbok => Ariados
Pikachu => Pikachu-belle
Raichu => Raichu-alola
Sandshrew => Sandshrew
Sandslash => Sandslash-alola
Nidoran-f => Poochyena
Nidorina => Absol
Nidoqueen => Lucario
Nidoran-m => Zigzagoon
Nidorino => Sneasel
Nidoking => Nidoking
Clefairy => Wooloo
Clefable => Hatterene
Vulpix => Vulpix
Ninetales => Ninetales
Jigglypuff => Bidoof
Wigglytuff => Flaaffy
Zubat => Emolga
Golbat => Oricorio-baile
Oddish => Oddish
Gloom => Roserade
Vileplume => Bellossom
Paras => Crustle
Parasect => Parasect
Venonat => Whimsicott
Venomoth => Volcarona
Diglett => Diglett
Dugtrio => Dugtrio-alola
Meowth => Vulpix-alola
Persian => Ninetales-alola
Psyduck => Toucannon
Golduck => Breloom
Mankey => Slakoth
Primeape => Annihilape
Growlithe => Growlithe
Arcanine => Houndoom
Poliwag => Wooper
Poliwhirl => Poliwhirl
Poliwrath => Ludicolo
Abra => Abra
Kadabra => Gothorita
Alakazam => Alakazam
Machop => Scrafty
Machoke => Mawile
Machamp => Krookodile
Bellsprout => Cacnea
Weepinbell => Lilligant
Victreebel => Tsareena
Tentacool => Shuckle
Tentacruel => Malamar
Geodude => Lechonk
Graveler => Clodsire
Golem => Metagross
Ponyta => Slugma
Rapidash => Chandelure
Slowpoke => Slowpoke
Slowbro => Tinkaton
Magnemite => Zorua
Magneton => Luxray
Farfetchd => Sirfetchd
Doduo => Corviknight
Dodrio => Skarmory
Seel => Spheal
Dewgong => Frosmoth
Grimer => Sandygast
Muk => Muk
Shellder => Sinistea
Cloyster => Cloyster
Gastly => Gastly
Haunter => Haunter
Gengar => Mismagius
Onix => Salazzle
Drowzee => Rockruff
Hypno => Stoutland
Krabby => Krabby
Kingler => Kingler
Voltorb => Toxapex
Electrode => Zebstrika
Exeggcute => Smoliv
Exeggutor => Exeggutor-alola
Cubone => Cubone
Marowak => Marowak
Hitmonlee => Gardevoir
Hitmonchan => Gallade
Lickitung => Spiritomb
Koffing => Drifloon
Weezing => Hippopotas
Rhyhorn => Tyrunt
Rhydon => Tyrantrum
Chansey => Sylveon
Tangela => Tangela
Kangaskhan => Bewear
Horsea => Seadra
Seadra => Kingdra
Goldeen => Skiddo
Seaking => Sharpedo
Staryu => Mimikyu-disguised
Starmie => Starmie
Mr-mime => Mr-rime
Scyther => Scizor
Jynx => Froslass
Electabuzz => Toxtricity-amped
Magmar => Ceruledge
Pinsir => Grimmsnarl
Tauros => Cofagrigus
Magikarp => Pumpkaboo-average
Gyarados => Dragalge
Lapras => Aurorus
Ditto => Ditto
Eevee => Teddiursa
Vaporeon => Vaporeon
Jolteon => Espeon
Flareon => Umbreon
Porygon => Archeops
Omanyte => Omanyte
Omastar => Mamoswine
Kabuto => Stunfisk
Kabutops => Garchomp
Aerodactyl => Flygon
Snorlax => Wailord
Articuno => Xerneas
Zapdos => Groudon
Moltres => Shaymin-land
Dratini => Larvitar
Dragonair => Dragonair
Dragonite => Goodra
Mewtwo => Arceus
Mew => Mew